乙	fish guts/latter
一	one
人	person
入	enter
八	eight
七	seven
十	ten
丁	street
力	power
九	nine
刀	katana
了	complete/finish
二	two
又	or again/again
亡	deceased
士	gentleman/gentleman's
工	craft
土	soil
子	child
才	genius
寸	measurement
女	woman
乞	beg
凡	mediocre/ordinary
上	above/up
下	below/down
山	mountain
口	mouth
小	little/small
川	stream/river
干	dry
千	thousand
巾	()/towels
夕	evening
及	reach out/lead-up-to
己	self
久	long-time
与	bestow/give
弓	bow
丈	length
大	large/big
三	three
万	ten-thousand
丸	round
刃	blade
午	noon
牛	cow
王	king
区	ward/districts
凶	villain/evil
匹	equal
太	plump/fat
夫	husband
犬	dog
天	heavens/heaven
日	day/sun
月	month/moon
円	circle/yen
比	compare
匂	()/smell
仇	()/foe
化	change
水	water
木	tree
不	negative
尺	shaku/foot-length
中	in
戸	door
方	direction
切	cut
分	part
幻	phantasm/illusion
仏	buddha
公	public
支	branch/support
反	anti-/oppose
友	friend
文	sentence
父	father
厄	unlucky
収	income
五	five
井	well/water-wells
互	mutually/together
内	inside
欠	lack
火	fire
心	heart
今	now
乏	destitution/poverty
双	pair
牙	tusk/fangs
介	jammed in/jammed-in
片	one-sided
元	beginning/origin
六	six
氏	family name/surnames
冗	superfluous
止	stop
予	beforehand
弔	condolences
刈	reap/trim
毛	fur/hair
手	hand
引	pull
少	few
爪	claw/nails
叩	()/bash
右	right
古	old
石	stone/rocks
兄	elder-brother
召	seduce
叶	()/fulfills
占	fortune-telling
叱	()/scolded
加	add/adding
台	pedestal
申	speaketh/statement
由	wherefore/reason
甲	armor
田	ricefield
払	pay
広	wide/broad
弁	valve/speech
用	utilize
皿	dish/plate
冊	tome/book-volumes
旦	nightbreak/dawn
旧	old-times
白	white
目	eye
主	lord/master's
生	life
玉	jewel/ball
未	not-yet
末	extremity/end-of
半	half
失	lose
矢	dart
本	book
犯	crime
代	substitute
汁	soup
刊	publish
庁	government-office
令	orders
巨	gigantic
央	center
史	history
礼	salutation/salute
付	adhere/attach
札	tag
丼	()/bowls
他	other/another
世	generation
瓦	tile
丘	hill
北	north
巧	adroit/skillfully
写	copy
号	nickname/title
必	invariably/certain
氷	icicle/ice
永	eternity
四	four
母	mama/mothers
囚	captured
立	stand-up
平	even/flat
正	correct
幼	infancy/childhood
功	achievement
玄	mysterious/profound
市	market/city
左	left
布	linen/cloth
司	director
可	can
句	phrase
民	people
尻	()/buttocks
込	crowded
辺	environs/vicinity
仙	hermit
打	strike
矛	halberd/spear
圧	pressure
仕	attend/serving
去	gone
処	dispose
奴	guy
皮	pelt/leather
以	by-means-of
穴	hole
出	exit
外	outside
示	show
冬	winter
汚	dirty
汗	sweat
江	creek
年	year
羊	sheep
寺	buddhist-temple
多	many
各	each
名	name
光	rays-of-light
米	rice
先	before/previous
全	whole/all
企	undertake/plans
合	fit
会	meeting
百	hundred
早	early
自	oneself
耳	ear
再	again/second-time
両	both
西	west
毎	every
血	blood
曲	bend
因	cause
団	group
回	-times
叫	shout
扱	handle
吸	suck/inhale
吐	spit
忙	busy
竹	bamboo
州	state
任	responsibility
伝	transmit
件	affair/matter
争	contend/dispute
危	dangerous
色	color
好	fond/like
安	relax/cheap
妄	delusion
次	next
巡	patrol
迅	swift
糸	thread
灯	lamp
兆	portent
弛	()/droops
地	ground
池	pond
列	file/queue
刑	punish/punishment
死	death
守	guard/protect
宇	eaves/roof
宅	home
字	character
肉	meat
舟	boat
向	yonder/facing
同	same
尖	()/sharp
行	going/go
劣	inferiority/inferior
考	consider
旨	delicious
老	old man/grow-old
伐	fell/cut-down
休	rest
壮	robust/grand
旬	decameron/10-days
充	allot/fill
芝	turf/lawn
伏	prostrated/face-down
仰	faceup/look-up
仮	provisional/temporary
匠	artisan/craftsman
舌	tongue
吉	good-luck
如	likeness/as-if
仲	go-between/relationship
虫	insect
存	suppose/aware
有	possess/have
在	exist
朴	crude/simple
肌	texture/skin
朽	decay
机	desk
当	hit
印	stamp/symbol
羽	feathers/feather
至	climax/attain
式	style
衣	garment/clothes
共	together/jointly
缶	tin can/tin-cans
交	mingle/intersect
尽	exhaust/use-up
気	spirit
成	turn into/become
灰	ashes
妨	disturb
励	encourage
助	help
村	town/village
対	vis-a-vis/versus
肘	()/elbow
近	near
返	return
迎	welcome
走	run
廷	courts/court
足	leg/foot
良	good
卵	egg
即	instant
却	instead
見	see
児	newborn babe/infant
貝	shellfish
身	somebody
困	quandary/trouble
囲	surround
図	map/diagram
医	doctor/medicine
更	grow late/furthermore
伸	expand/extend
車	car
戻	re-/put-back
尾	tail
尿	urine
何	what
局	bureau
伺	pay respects/ask
材	lumber/materials
杖	()/cane
杉	cedar
庇	()/defend
批	criticism
屁	()/fart
序	preface
応	apply/respond
床	bed/floor
町	village/town
里	ri/hometown
男	man
含	include
余	too much/surplus
冷	cool
呑	()/swallow
豆	beans
呂	spine/articulate
臣	retainer/government-official
来	come
串	shish kebab/shish-kebab-skewers
弟	younger brother/younger-brother
妥	gentle/compromise
災	disaster
芯	()/central-part
芳	perfumed/fragrant
花	flower
芸	technique/art
完	perfect/complete
究	research
売	sell
赤	red
利	profit/benefit
別	separate
私	private
判	judgment
坂	slope
均	level/average
坊	boy
妙	exquisite/strange
妖	()/ghost
妊	pregnancy/pregnant
呆	()/shocked
克	overcome
束	bundle
技	skill/technique
抜	slip out/remove
岐	branch off/branch-off
忘	forget
志	intention
忍	endure/sneak
忌	mourning/detestable
決	decide
択	choose/select
沢	swamp
吠	()/bark
吹	blow
状	status quo/condition
汲	()/draws-water
汽	vapor/steam
沈	sink/submerge
似	similar
伴	consort/accompany
低	lower/low
佐	assistant
役	duty/role
投	throw
没	drown/sink
呈	display
狂	lunatic/crazy
弄	()/mess-around-with
改	reformation/renew
攻	aggression/assault
快	cheerful/pleasant
努	toil/effort
労	labor
秀	excel
否	negate/refuse
告	revelation/inform
谷	valley
声	voice
君	old boy/you
把	grasp
求	request
条	twig/clause
寿	longevity
麦	barley/wheat
初	first-time
乱	riot/disorder
社	company/shrine
言	say
角	angle
肖	resemblance/portrait
抗	confront/protest
折	fold
抑	repress/restrain
位	rank
住	dwell/reside
体	body
作	make
戒	commandment/warn
形	shape
我	ego/my
希	hope
系	lineage/system
辛	spicy
兵	soldier
邦	home country/home-country
防	ward off/prevent
肝	liver
押	push
呻	()/groan
果	fruit/accomplish
尚	esteem/still
画	brush stroke/drawing
雨	rain
周	circumference/surroundings
妬	()/jealous
拓	clear the land/clear-the-land
岩	boulder
協	co-/cooperation
拗	()/distort
効	merit/effect
抽	pluck/extract
油	oil
宙	mid-air
届	deliver
炊	cook
炎	inflammation/flames
炉	hearth/fireplace
昔	once upon a time/long-ago
昏	()/dusk
者	someone
的	bull's eye/target
泊	overnight/stay-overnight
拍	clap/music-beat
迫	urge/imminent
肯	agreement/agree
育	bring up/raise-a-child
肩	shoulder
青	blue
枢	hinge/pivot
殴	assault/punch
欧	europe
拒	repel/reject
肪	obese/fatty
肢	limb
肥	fertilizer
股	()/crotch
明	bright
服	clothing
突	stab/poke
定	determine
空	empty
宝	treasure
房	tassel/chambers
居	reside/residence
刷	printing/print
泥	mud
姉	older-sister
妹	younger-sister
始	commence/start
事	matter/things
妻	wife
垂	droop/dangling
知	know
委	committee/entrust
和	harmony
呼	call
呟	()/mutter
呪	()/curse
味	flavor
拡	broaden/expand
拝	worship
抹	rub
招	beckon/invites
沼	marsh
拐	kidnap/kidnapped
到	arrival/arrives
制	system/structure
刻	engrave/carve
刺	thorn/stab
毒	poison
取	take
侮	scorn/despise
邪	wicked
阻	thwart/impede
邸	residence/mansion
況	but of course/situation
治	reign/cure
泳	swim
沸	seethe/boiling
併	join/combine
供	submit/offer
価	value
受	accept
学	study
乳	milk
宜	best regards/fine
狙	()/aim
直	straightaway/directly
具	tool
祈	pray/praying
析	chop/analyze
所	place
彼	he
披	expose/presentation
版	printing block/edition
波	waves
枕	()/pillow
枠	frame
板	plank/board
岸	beach/coast
拙	bungling/incompetent
屈	yield/crouched
若	young
苦	suffering/suffers
店	store
英	england/english
東	east
典	code/ceremony
苗	seedling
松	pine tree/pine-trees
林	grove/woods
杯	cupfuls/cups
法	method
沿	run alongside/alongside
泡	bubble
金	gold
命	fate/lifeforce
舎	cottage/buildings
念	wish/desire
武	warrior/battle-strength
延	prolong
些	()/slight
依	reliant/depends-on
使	use
例	example
夜	night
卒	graduate
京	capital
怯	()/frightened
怖	dreadful/scary
怪	suspicious
径	diameter
性	sex/nature-of
姓	surname/family-name
往	journey/go-out
注	pour
枚	sheet of/sheets-of
枝	bough/branches
放	set free/release
府	municipality/province
抵	resist/defying
底	bottom
物	thing/object
忽	()/immediately
忠	loyalty
易	easy
承	acquiesce/assent
参	visit
季	seasons/season
実	reality/truth
宗	religion
官	bureaucrat/government
宛	address/addressed-to
祉	welfare/well-being
歩	walk
征	subjugate/conquer
奇	strange/odd
河	river/stream
斉	adjusted/simultaneously
苛	()/torments
茂	overgrown/grows-thick
芽	bud/sprouts
茎	stalk/stems
盲	blind
昆	descendants/bugs
昇	rise up/ascend
卓	eminent/table
担	shouldering/manager
抱	embrace
拘	arrest/confine
拠	foothold/basis
券	ticket
奔	bustle/wild
虎	tiger
並	row/line-up
述	mention/express
泣	cry/cries
免	excuse
弦	bowstring/string-instrument
侍	waiter/samurai
玩	()/toy
非	un-/not
固	harden/firm
門	gates
国	country
表	surface
奉	dedicate/volunteer
長	long
幸	happiness
訂	revise
訃	()/obituary
計	plot/measure
郎	son/young-man
恨	resentment/resents
限	limit
郊	outskirts/suburbs
型	mould/type
剃	()/shaves
則	rule
削	plane/scraping-off
変	unusual
哀	pathetic/pity
亭	pavilion/inn
貞	upright/virgin
頁	page
負	defeat/defeated
赴	proceed
施	alms/execute
甚	tremendously/immense
政	politics
卸	wholesale
歪	()/warp
是	just so/righteous
送	send off/send
迷	astray/lost
逃	escape
前	in front/before
面	mask
首	neck
皇	emperor
星	star
牲	animal sacrifice/animal-sacrifice
奏	play music/play-an-instrument
巻	scroll/roll
美	beauty/beautiful
為	do/for
県	prefecture
点	spot/point
珍	rare
叙	confer/describe
食	eat
炭	charcoal
幽	faint/hazy
峠	mountain pass/peak
品	goods
飛	fly
盆	basin/tray
垢	()/filth
垣	hedge/bamboo-fence
城	castle
拭	()/wipe
拷	torture
挑	challenge
疫	epidemic
段	grade/steps
度	degrees
咲	blossom/bloom
咽	()/choke
咳	()/cough
革	leather/reform
帝	sovereign/empire
南	south
風	wind
殆	()/almost
故	happenstance/circumstances
軌	rut/track
俗	vulgar/customary
促	stimulate/motivate
俄	()/suddenly
侵	encroach/invading
契	pledge
臭	stinking/smelly
泉	spring
専	specialty/specialize
封	seal/sealing
耐	-proof/endure
厚	thick
威	intimidate/authority
虐	tyrannize/cruel
盾	shield
査	investigate/investigation
看	watch over/look-after
恰	()/as-though
悔	repent/regrets
恒	constancy/unchanging
某	so-and-so/anonymous
架	erect/construct
柔	tender/soft
染	dye/dyed
信	faith/believe
便	convenience/convenient
係	person in charge/clerk
保	protect/preserves
退	retreat
逆	inverted/reverse
追	chase
砕	smash
砂	sand
研	polish/sharpen
窃	stealth/stealthy
宥	()/soothed
宣	proclaim/proclaiming
畑	farm/field
背	stature/back
胃	stomach
怒	angry
怨	grudge
怠	neglect/lazy
急	hurry
括	fasten/tie-together
指	finger
拾	pick up/pick-up
浄	clean
洞	den/cave
海	sea
虹	rainbow
狩	hunt
紅	crimson
独	single/alone
活	lively
派	faction/clique
洗	wash
浅	shallow
洪	deluge/floods
洋	ocean/western
昧	()/unclear
昨	yesterday
昭	shining
映	reflect/reflected
約	promise/promised
級	class
紀	chronicle/century
律	rhythm/law
建	build
津	haven/seaport
皆	all/everyone
音	sound
香	incense/fragrance
春	springtime
軍	army
栄	flourish/prospers
冠	crown
後	behind/after
待	wait/waited
持	hold
穿	()/digs
客	guest
室	room
屋	roof/shop
屍	()/corpses
昼	daytime
卑	lowly
単	simple/single
勇	courage
祖	ancestor
祝	celebrate/celebrated
神	gods
冒	risk/risked
省	focus/omitting
眉	()/eyebrows
畏	()/respect
界	world
思	think
発	discharge/departure
重	heavy
乗	ride
秋	autumn
科	department
秒	second
狭	cramped/narrow
峡	gorge
挟	sandwiched
孤	orphan/solitary
狐	()/fox
弧	arc/arch
茨	briar/thorny
茸	()/mushrooms
荘	villa
要	need
姦	()/adultery
姻	matrimony/marry
姿	figure
荒	laid waste/rough
茶	tea
草	grass
胞	placenta/cells
肺	lungs
胎	womb
胆	gall bladder/gall-bladder
柄	design/characteristic
柱	pillar
枯	wither/withered
相	inter-/each-other
閃	()/flash
座	sit
挫	()/sprain
差	distinction/variation
砲	cannon/canon
祥	auspicious/favorable
師	expert/teacher
紋	family crest/pattern
蚊	mosquito
眩	()/dizzy
罠	()/trap
眠	sleep
挙	raise
拳	()/fist
益	benefit/profit
般	carrier/category
航	navigate
殺	kill
匿	hide/conceal
馬	horse
島	island
疲	tired
被	incur/cover
破	rend/rip
竜	dragon
祟	()/haunts
峰	summit
討	chastise/debated
射	shoot
将	leader
笑	laugh/laughed
弱	weak
帯	sash/belt
恥	shame
時	time
耽	()/absorbed-in
特	special
逝	departed/die
唆	tempt
哲	philosophy
倉	godown/warehouse
剣	saber/swords
飢	hungry/starving
恭	respect/admiration
党	party/political-party
俸	stipend/salary
旅	trip/travel
孫	grandchild
索	cord/seek
素	elementary/plain
班	squad
帰	homecoming/return-home
浸	immersed/soak
兼	concurrently
書	write/writing
冥	()/underworld
辱	embarrass/humiliate
娠	with child/pregnancy
振	shake
唇	lips
扇	fan
屑	()/scraps
展	unfold/development
徐	gradually
除	exclude
途	route
捜	search
捕	catch/capture
捉	()/catch
挿	insert/inserted
称	appellation/praise
秩	regularity/organized
秘	secret
租	tariff/taxation
剥	()/peel
剛	sturdy
剤	dose
高	tall
華	splendor/gorgeous
荷	baggage/luggage
衰	decline
朗	melodious/cheerful
狼	()/wolf
既	previously/already
根	root
悩	trouble/worry
悟	enlightenment/comprehend
悦	ecstasy/joy
症	symptoms
病	ill/illness
疾	rapidly/quickly
耕	till/plow
栽	plantation/planting
耗	decrease/expend
珠	pearl
殊	particularly
株	stocks
娘	daughter
姫	princess
娯	recreation/pleasure
捗	()/progressing
挽	()/grinding
捌	()/deal-with
通	traffic/pass-through
速	quick/fast
透	transparent
造	create/created
陥	collapse/fall-into
降	descend
院	inst./institution
納	settlement/payment
純	genuine/pure
紐	()/string
紛	distract/confusing
舐	()/licked
紙	paper
配	distribute
酒	sake/alcohol
酌	bartending/pour-alcohol
勉	exertion/diligent
従	accompany/obeys
起	rouse/wake
徒	junior/on-foot
挨	()/greeting
捩	()/twisted
涙	tears
埃	()/dust
凄	()/amazing
凌	()/survive
凍	frozen/freeze
員	employee/members
財	property
針	needle
釘	()/nails2
恐	fear
恵	favor/blessed
恋	romance
恩	grace/grateful
核	nucleus/core
栓	plug/cork
桁	()/digits
脅	threaten/threatened
骨	skeleton/bones
宵	wee hours/nightime
留	detain/stay
袖	sleeve
畜	livestock
息	breath
鬼	ghost/demon
埋	bury/buried
残	remainder/remain
能	ability
烈	ardent/intense
真	true
夏	summer
貢	tribute/contribute
家	house
容	contain
宴	banquet/party
案	plan/proposal
宮	shinto shrine/palace
害	harm
連	take along/take-along
軒	flats/overhang
庫	warehouse/storehouse
陣	camp/military-encampment
原	meadow
席	seat
庭	courtyard/garden
料	fee
粉	flour/powder
粋	chic/stylish
胸	bosom/chest
脈	vein/pulse
脂	fat/grease
脇	armpit
胴	trunk/torso
脆	()/fragile
敏	cleverness/agile
致	doth/end-up
倒	overthrow/collapsing
梅	plum
格	status
校	exam/school
桃	peach tree/peach
桜	cherry tree/cherry-blossom
浪	wandering
浜	seacoast/beach
浮	floating/float
浴	bathe
流	current/flowing
消	extinguish/erase
俳	haiku/actor
修	discipline/fix
候	climate/weather
俺	()/i
倫	ethics
個	individual
値	price
借	borrow
倍	double
記	scribe/noted
訓	instruction/training
託	consign/assign-responsibility
進	advance/move-forward
週	week
逸	elude/avert
副	vice-/second-in-command
側	side
酔	drunk
執	tenacious/persistent
務	task
殻	husk/shells
袋	sack/bags
移	shift/transfer
瓶	flower pot/bottle
釈	interpretation/explanation
寄	draw near/approach
宿	inn/lodging
密	secrecy/confidential
欲	longing/want
盗	steal
盛	boom/thriving
唱	chant
望	ambition/wish
崩	crumble
庶	commoner/ordinary-person
鳥	bird
魚	fish
菓	confectionary/candy
巣	nest
異	uncommon/vary
偵	spy/scouting
偶	accidentally/unexpectedly
偏	partial/biased
偽	falsehood/false
祭	ritual/festival
票	ballot/vote
崇	adore/admire
描	sketch/draw
菌	germ/bacteria
黄	yellow
猫	cat
率	ratio/percentage
章	badge/chapter
商	make a deal/trade
虚	void/vacant
産	products/produce
鹿	deer
麻	hemp/numb
累	accumulate/accumulating
略	abbreviation
亀	tortoise/turtles
術	art/skill
得	gain
痒	()/itchy
痕	()/scar
彫	carve/engrave
彩	coloring
惨	wretched/miserable
済	finish/conclude
淡	thin/pale
添	annexed/attachment
停	halt/cease
涼	refreshing
液	fluid/liquid
械	contraption/machine
桶	()/bucket
梯	()/ladder
眼	eyeball
眺	stare/gaze
郷	hometown/birthplace
符	token/mark
第	no./rank-number
笛	flute
舵	()/ship-steering-rudder
舶	liner/vessel
船	ship
脳	brain
脱	undress
豚	pork/pig
脚	shins/legs
掃	sweep/sweeping
授	impart/receive
捲	()/turn-the-page
掴	()/grab
捧	()/dedicate
排	repudiate/eliminate
控	withdraw/refrains
掛	hang/put
接	touch/connect
採	pick
捨	discard/throw-away
据	set
患	afflicted/sick
悠	remote/relaxed
悪	bad
窓	window
惚	()/fall-in-love
偲	()/recall
著	renowned/authored
猪	boar
都	metropolis
探	grope/looking-for
梨	pear tree/pear
深	deep
唸	()/growled
捻	()/wrenched
斜	diagonal
釣	angling/fishing
渉	ford/involved
寂	loneliness/lonely
戚	()/relatives
渋	astringent/bitter
婦	lady
婆	old woman/grandmother
婚	marriage
萎	()/wilted
剰	surplus/excess
唾	()/saliva
郵	mail/mailing
猟	game hunting/hunting-animals
猛	fierce
動	move
勘	intuition
雪	snow
常	usual
堂	hall/auditorium
強	strong
張	lengthen/affix
帳	notebook
掻	()/scratch
蛍	lightning bug/firefly
蛇	snake
推	conjecture/assume
唯	solely/only
雀	()/sparrow
部	section
陪	auxiliary/aids
培	cultivate/cultivating
販	marketing/sale
旋	rotation/rotating
敗	failure/failed
族	tribe/family
域	range/area
掘	dig/excavated
堀	ditch/canal
理	logic
野	plains
黒	black
康	sane/physically-fit
健	healthy
逮	apprehend/arrest
粛	solemn/silent
規	standard/regulation
現	present/appeared
視	inspection/look
習	learn/learned
混	mix/mixed
翌	the following/the-following
基	fundamentals/foundation
涯	horizon
崖	()/cliff
惜	pity/regrettable
措	set aside/course-of-action
悼	lament/mourning
掲	put up a notice/posted
喝	hoarse/reprimanding
渇	thirst/thirsty
断	severance/turned-down
粗	coarse
粘	sticky
粒	grains
情	feelings/emotion
責	blame
清	pure/clear
貧	poverty/poor
貨	freight/money
貫	pierce
斬	()/chop-off
乾	drought/dries-out
転	revolve/fall-down
軟	soft/soft-quality
頃	()/occasion
貪	()/greed
頂	place on the head/top
菜	vegetable
渓	mountain stream/ravine
淫	()/lewd
閉	closed/close
爽	()/invigorating
問	question
険	precipitous/steep
陶	pottery
陰	shade/shadows
陸	land
隆	hump/flourish
陳	line up/declared
絆	()/bonds
経	sutra/elapses
紹	introduce/introduction
紺	navy blue/dark-blue
赦	pardon
教	teach/teaching
球	ball/sphere
救	salvation/rescue
終	end
細	dainty/thin
紳	sire/refined-man
組	association/assemble
許	permit
設	establishment/establish
訳	translate
訪	call on/go-and-see
訟	sue
這	()/crawling
弾	bullet/bounced
圏	sphere/range
湾	gulf/bay
補	supplement
傍	bystander/beside
偉	admirable/great
備	equip/prepare
揺	swing/swaying
遥	()/distant
援	abet/assist
猥	()/obscene
湧	()/gushed
隈	()/shade
閑	leisure/leisurely
焚	()/light-a-fire
森	forest
普	universal/general
道	road-way/roads
着	don/wear
湿	damp
鈍	dull
飯	meal
飲	drink
悲	sad
扉	front door/front-door
斐	()/worthwhile
喜	rejoice/glad
善	virtuous/excellent
量	quantity
童	juvenile/youngsters
達	accomplished/reach
就	concerning/commence
報	report
晴	clear up/clear-up
惰	lazy/sloth
博	dr./expert
葬	interment/burial
募	recruit
落	fall/drop
棺	coffin
椅	()/chair
棒	rod/pole
塀	fence
堰	()/dam
堪	withstand
幾	how many/how-much
紫	purple
傘	umbrella
滋	nourishing/nourishment
番	turn
歯	tooth
奥	core/inner
尊	revered/esteem
猶	waver/postponed
酢	vinegar
富	wealth
帽	cap/hats
幅	hanging scroll/width
粧	cosmetics/makeup
距	long-distance/distance
堅	strict/solid
覚	memorize/remember
営	occupation/conducting-business
覗	()/peek
象	elephant/image
隊	regiment/squadron
遂	consummate/achieve
創	genesis/begin
割	proportion/divide
慌	disconcerted/panicking
街	boulevard/avenue
御	honorable
復	restore/restored
循	sequential/circulation
棟	ridgepole/ward
疎	alienate/ignorant
棘	()/thorns
塁	bases
畳	tatami mat/tatami-mat
喧	()/noisy
握	grip
硬	stiff/hard
属	belong
裁	tailor/judge
装	attire/dresses
喪	miss/funeral
裂	split
搭	board/load
塔	pagoda/tower
裕	abundant/rich
答	solution/answer
集	gather
葉	leaf
喋	()/speak
絞	strangle/wring
給	salary/provide
結	tie
敢	daring/brave
敬	awe/show-respect
散	scatter/scattering
寒	cold
衆	masses/many-people
掌	manipulate/palm-of-my-hand
換	interchange/exchanged
喚	yell
喫	consume/consuming
喉	()/throat
測	fathom/assess
貯	savings
貼	()/stick
雇	employ/hired
雄	male
焦	char
喘	()/panting
嵐	storm
嵌	()/fit-into
隅	corner
過	overdo/excessive
渦	whirlpool
遇	interview/encountered
場	location
湯	hot water/hot-water
陽	sunshine/sunlight
揚	hoist/lift
稀	()/uncommon
税	tax
程	extent
絶	discontinue/terminate
絵	picture
統	overall/unify
絡	entwine/entangled
媒	mediator/go-between
欺	deceit/deceives
揉	()/massages
智	wisdom
替	exchange/replace
晶	sparkle/crystal
揃	()/assembled
愉	pleasure/enjoyable
喩	()/metaphors
満	full/satisfied
減	dwindle/decreases
渡	transit/crosses
湖	lake
港	harbor
温	warm/warm-temperature
暑	sultry/hot-weather
最	utmost/most
景	scenery
煮	boil/simmering
然	sort of thing/like-that
無	nothingness/nothing
随	follow/freely
殖	augment/multiplying
階	story/stairs
痢	diarrhea
痛	pain
痩	()/lose-weight
尋	inquire
惑	beguile/perplexing
廊	corridor
廃	abolish/abolished
遍	everywhere
遅	slow
遊	play/playing
開	open
悶	()/agony
間	interval/space
検	examination/inspection
植	plant
極	poles/extreme
等	etc./equivalent
策	scheme
筋	muscle
筆	writing brush/writing-brush
筒	cylinder
詞	parts of speech/words
腕	arm
腔	()/cavity
勝	victory/win
越	surpass/passes
提	propose/submit
堤	dike
超	transcend/exceeds
揮	brandish/commanded
運	carry
軽	lightly/light
軸	axis
暁	daybreak
晩	nightfall/nighttime
焼	bake/roasting
期	period
朝	morning
棚	shelf
厨	()/kitchen
登	ascend/climb
短	short
買	buy
貰	()/get
貿	trade/trading-activity
雰	atmosphere
勤	diligence/hard-working
雲	cloud
順	obey/sequence
項	paragraph
須	ought/required
賀	congratulations/celebration
貸	lend
貴	precious/valuable
費	expense
評	evaluate
証	evidence
詐	lie/fraud
訴	accusation/appealed
詠	recitation/compose-poetry
診	checkup/medical-examinations
裏	back/back-side
蓄	amass/amasses
塊	clod/lumps
嗅	()/sniffing
漠	vague
奨	exhort/promote
滞	stagnate/delayed
羨	envious
溝	gutter/ditches
義	righteousness/obligations
較	contrast/comparison
摂	vicarious/intake
聖	holy/sacred
寛	tolerant/generous
窟	()/cavern
碗	()/tea-bowls
寝	lie down/lie-down
詳	detailed
新	new
群	flock/gather-together
辞	resign
睨	()/glare
鼠	()/mouse
献	offering/contribution
慎	humility/careful
債	bond/debt
慨	rue/emotional
督	coach/supervise
僧	buddhist priest/buddhist-monk
腎	()/kidneys
夢	dream
置	placement/positioned
署	signature/government-organization
罪	guilt/guilty
虜	captive
勢	forces/energy
廉	bargain/inexpensive
傑	greatness/outstanding
準	semi-/standard
携	portable
傷	wound
嗜	()/fond
嗄	()/hoarse
嘩	()/quarrel
滝	waterfall
溶	melt/melted
滑	slippery/slip
福	blessing/good-fortune
隔	isolate/isolated
隙	()/gap
照	illuminate/illuminated
蒸	steam/vapor
煎	()/brewing
腫	()/swelling
勧	persuade/recommend
働	work
睡	drowsy
頑	stubborn
預	deposit/depositing
傾	lean/inclined
鼓	drum
頓	()/rapidly
煩	anxiety/annoying
靴	shoes
僅	()/a-little
煙	smoke
戦	war
裸	naked
禅	zen
歳	year-end/year-old
滅	destroy/ruin
載	load/placement
腺	()/glands
腹	abdomen
腰	loins/waist
腸	intestines
継	inherit
続	continue
絹	silk
賃	fare/rate
資	assets
損	damage/losses
催	sponsor/hold-an-event
稚	immature/childish
雅	gracious/elegant
搬	conveyor/transport
殿	mr./imperial-palace
裾	()/hem
源	source
溺	()/drown
溜	()/accumulates
豊	bountiful/abundant
嵩	()/volume
農	agriculture/farm
嫌	dislike
嫁	marry into/bride
嫉	()/envy
跡	tracks/trace
跳	hop/jumping
路	path
嘆	sigh/grief
漢	sino-/chinese
酬	repay/reward
賊	burglar/thief
賂	()/bribery
賄	bribe
鈴	small bell/small-bells
鉄	iron
鉢	bowl/flowerpot
鉛	lead (metal)/lead
鉱	mineral
幹	tree trunk/tree-trunk
跨	()/straddle
誇	boast/proud
該	above-stated/applicable
飽	sated/tired-of
飼	domesticate/raising-an-animal
飾	decorate
節	node/time-of-year
溢	()/overflowing
禁	prohibition/ban
塗	paint/painting
塩	salt
盟	alliance
塞	()/block
話	tale/talk
誉	reputation/honor
詫	()/apologize
誠	sincerity/sincere
詰	packed/pack
詣	()/visit-a-temple
試	test
詩	poem
詮	()/discussion
馴	()/familiar-with
鳩	pigeon
墓	grave
幕	curtain
雷	thunder/lightning
零	zero
電	electricity
触	contact/touch
蜂	()/bee
解	unravel
愛	love
暇	spare time/free-time
暗	darkness/dark
暖	warmth/warm-weather
遠	distant/far
園	park
猿	monkey
想	concept/thought
感	emotion/feel
愚	foolish
意	idea
棄	abandon
楽	music/fun
業	profession/business
微	delicate/subtle
違	difference
数	number
痴	stupid
痺	()/paralyzed
遣	dispatch
魂	soul
銃	gun
鞄	()/briefcase
寧	rather/polite
僕	me
窪	depression/hollow
算	calculate
箇	item
管	pipe
鼻	nose
徴	indications/features
旗	national flag/flag
複	duplicate/multiple
疑	doubt
穀	cereals/cereal-grain
製	made in.../manufacutured
需	demand
歌	song/sing
端	edge/tip
彰	patent/commended
障	hinder/obstacles
境	boundary
塵	()/garbage
腐	rot
塾	cram school/cram-school
貌	()/appearance
稲	rice plant/rice-plant
種	species/seeds
暮	livelihood/becomes-dark
蔑	()/contempt
慕	pining/adores
像	statue
豪	overpowering/powerful
僚	colleague
歴	curriculum/past
暦	calendar
蜜	honey
踊	jump/dance
慣	accustomed
賑	()/bustling
領	jurisdiction/territory
構	posture/care
様	esq./mr.
模	imitation/imitate
憎	hate
増	increase
層	stratum/layers
遭	encounter/ran-into
遮	intercept/obstructing
適	suitable/appropriate
嘘	()/lie
碑	tombstone/stone-monument
鳴	chirp/ring
磁	magnet
漂	drift/drifting
漏	leak/leaking
漕	rowing/rowed
演	performance
漁	fishing/catch-a-fish
漆	lacquer
銘	inscription
銀	silver
銅	copper
銭	coin
酸	acid
酵	fermentation
酷	cruel/harsh
慢	ridicule/boast
漫	loose/manga
髪	hair of the head/hair-on-my-head
聞	hear
閥	clique/faction
関	connection/related
閣	tower/government-cabinet
静	quiet
精	refined
漬	pickling/pickled
奪	rob/take-away
雑	miscellaneous
維	fiber
雌	female
徳	benevolence/moral
態	attitude
熊	bear
遜	()/humble
腿	()/thigh
膜	membrane
罰	penalty
誓	vow
獄	prison
際	occasion/moment
察	guess/observe
隠	conceal/hide
駆	drive
駄	burdensome/useless
駅	station/train-station
概	outline/summary
滴	drip/drop-of-water
摘	pinch
認	acknowledge
誘	entice/temptation
語	word/language
誌	document
説	explanation/theory
読	read
誤	mistake/errors
練	practice
綴	()/spell
緑	green/"green"
緒	thong/with
総	general/total
綿	cotton
綱	hawser/rope
網	netting/net
綻	()/coming-apart
聡	()/wise
歓	delight/delighted
舞	dance/dance-performance
確	assurance/accurate
権	authority/rights
監	oversee/supervision
盤	tray/flat-boards
蔵	storehouse/storage
舗	shop/pavement
澄	lucidity/serene
皺	()/wrinkled
撫	()/stroking
墜	crash
撲	slap/sumo
魅	fascination/attractive
頬	()/cheeks
踏	step/step-on
憂	melancholy/sorrow
履	footgear/footwear
膝	()/knee
嘲	()/ridicule
潮	tide
糊	()/glue
審	hearing/examination
寮	dormitory
窮	hard up/cornered
儚	()/fleeting
養	foster
僻	()/remote
儀	ceremony/manners
趣	gist/taste
暴	outburst/violent
撮	snapshot/photographs
褒	praise/compliment
敵	enemy
敷	spread/laying
劇	drama
慮	prudence/consideration
戯	frolic/game
膚	skin/skin-surface
嬉	()/happy
弊	abuse
幣	cash/currency
餅	()/mochi
餌	()/bait
餓	starve/starvation
蝿	()/houseflies
蝶	butterfly/butterflies
縄	straw rope/straw-rope
噂	()/rumor
嘱	entrust/commissioned
噛	()/bite
編	compilation/knit
緩	slacken/loose
縁	affinity/edge
線	line
締	tighten
緊	tense/tension
潔	undefiled/cleanliness
撤	remove/withdrawing
徹	penetrate/thoroughly
撒	()/sprinkling
衝	collide/collision
霊	spirits/phantom
器	utensil/containers
震	quake
憧	()/look-up-to
導	guidance/guide
選	elect/choose
影	shadow/silhouette
稽	()/pondering
稼	earnings/earn
稿	draft
遺	bequeath/inheritance
賞	prize
潰	()/crush
勲	meritorious deed/medal
熟	mellow/ripe
黙	silence
熱	heat
慰	consolation/console
億	hundred million/hundred-million
穂	ear of a plant/ear-of-a-plant
暫	temporarily/a-little-while
輝	radiance/radiant
輩	comrade
輪	wheel
摩	chafe/friction
撃	beat/attack
鋭	pointed/sharpness
標	signpost/sign
横	sideways/horizontal
槽	vat/tub
賠	compensation
閲	review/browse
賜	grant/gifts
潤	wet/moist
賛	approve
質	substance/quality
潜	submerge/diving
罵	()/insult
駒	pony/board-game-piece
駐	parking
範	pattern/scope
箸	()/chopstick
箱	box/boxes
憤	aroused/furious
諸	various
噴	erupt/erupted
課	chapter/assignment
調	tune/investigate
談	discuss/conversation
請	solicit/claim
誕	nativity/birth
論	argument/opinion
誰	()/who
諾	consent
誼	()/friendship
賭	gamble
賢	intelligent/clever
獣	animal/beast
薦	recommend/recommendation
磨	grind/polish
糖	sugar
輸	transport/transportation
麺	()/noodles
壇	podium/platform
醒	()/awake
曇	cloudy weather/cloudy
積	volume/piled-up
縦	vertical
髭	()/beard
縛	truss/bind
縫	sew
緯	horizontal/latitude
繁	luxuriant/prosperity
還	send back/go-back
避	evade/avoid
壁	wall
獲	seize/acquired
擁	hug/protection
奮	stirred up/excited
操	maneuver/operate
薬	medicine/drug
築	fabricate/construction
衛	defense/guards
衡	equilibrium/balance
燃	burn/burning
興	entertain/interest
膨	swell/expansion
龍	()/old-dragon
骸	()/skeleton
橋	bridge
樹	timber-trees/forest-trees
機	mechanism/device
穏	calm
憶	recollection/memory
憲	constitution
整	organize/adjust
憩	recess/take-a-break
凝	congeal/stiff
親	parent
隣	neighboring/neighbors
頼	trust/rely
頭	head
激	violent/fierce2
濃	concentrated
薄	dilute/diluted
融	dissolve/financing
館	bldg./large-building
濁	voiced/muddy
錬	tempering/strengthen
錆	()/rust
錠	lock
録	record/recorded
錯	confused/mistake
鋼	steel
嬢	lass/young-lady
壊	demolition/break
懐	pocket
謀	conspire/plot
諭	rebuke/persuade
諦	()/give-up
謡	noh chanting/song
濯	laundry/rinse
環	ring/environment
燥	parch/dryer
轄	control
繋	()/link
儲	()/profitable
贅	()/luxury
曜	weekday/day-of-the-week
難	difficult
観	outlook/view
鎮	tranquillize/suppress
鎌	sickle
鎖	chain
擬	mimic/simulation
擦	grate/rub-together
鮮	fresh
闇	()/darkness
癌	()/cancer
療	heal/treatment
聴	listen/listening
臆	()/coward
懇	sociable/sincerely
鍛	forge/forging
鍵	()/keys
鍋	()/pots
醜	ugly
講	lecture
購	subscription/purchasing
醤	()/soy-sauce
繊	slender/delicate
績	exploits/results
縮	shrink/shrinking
霜	frost
霞	()/mist
濡	()/wet
償	reparation
覧	perusal/watching
頻	repeatedly/frequently
齢	age
曖	()/ambiguous
犠	sacrifice
優	tenderness/kind
謝	apologize/thank
謙	self-effacing/modest
謹	discreet/paying-attention
謎	()/puzzle
厳	stern/strict
糞	()/excrement
翼	wing
瞳	pupil
職	post/job
織	weave/weaving
繕	darning/mending
礎	cornerstone/basic
襟	collar
襖	()/sliding-door
鯉	carp/koi-fish
贈	presents/present
糧	provisions/food
騎	equestrian/horseman
騒	boisterous/makes-noise
験	verification/experience
癒	healing/healed
懲	penal/disciplinary
覆	capsize/covered-with
臨	look to/confront
穫	harvest
瞬	wink/instanteous
鞭	()/whip
簡	simplicity/simplified
闘	fight
翻	flip/flipped
類	sort
題	topic/subject
顔	face
顕	appear/become-apparent
癖	mannerism/habit
額	forehead/amount
韓	korea
鏡	mirror
爆	bomb/explodes
願	petition/please
繰	winding/repeat
蹴	()/kick
蟻	()/ants
覇	hegemony/dominates
麗	lovely/pretty
霧	fog
識	discriminating/conscious
警	admonish/police
臓	entrails/organs
離	detach/separation
羅	gauze/arrange
艶	glossy/shiny
瀕	()/verge-of
瀬	rapids/river-shallows
簿	register/registry
騙	()/tricked
蘇	()/revive
鯨	whale
鶏	chicken
懸	suspend/hanging
鐘	bell
騰	inflation/rise
欄	column
競	vie/competing
籍	enroll/publication
響	echo/echoes
議	deliberation/conference
譲	defer/transfer-ownership
護	safeguard/protector
轟	()/roar
魔	witch/magic
艦	warship
顧	look back/look-back
露	dew
躍	leap
驚	wonder/surprise
鑑	specimen/appraise
鶴	crane
襲	attack/make-an-attack
沖	open sea/open-sea
硫	sulfur/sulphur
礁	reef
俊	sagacious/talented
伯	chief/uncle
啓	disclose/enlightenment
或	()/or
享	receive/acceptance
祷	()/prayer
禍	calamity/misfortune
曹	cadet/sergeant
瞑	()/close-your-eyes
瞭	()/clarity
羞	()/ashamed
甥	()/nephew
瘤	()/lump
摯	()/serious
俵	bag/straw-bag
壌	lot/ground-soil
蓋	()/lid
藻	seaweed
菊	chrysanthemum
掟	()/decree
楚	()/neat
淀	()/stagnant
抉	()/scoop-out
扮	()/disguise
拶	()/salutation
汰	()/sift
沙	()/fine-sand
炒	()/fried
鬱	()/depressed
遷	transition
粥	()/rice-porridge
墨	black ink/black-ink
牽	()/drag
尉	military officer/military-officer
碁	go
猾	()/sly
狡	()/cunning
狸	()/racoon
獅	()/lion
徘	()/roam
徊	()/wander-around
凧	()/kites
此	()/this
麓	()/foot-of-the-mountain
雛	()/chicks
於	()/at
筈	()/supposed
泰	peaceful
薪	firewood
秤	()/scale
宰	superintend/oversee
款	goodwill/subsection
淑	graceful
叔	uncle/aunt's
隷	slave
愕	()/astonished
酎	()/shochu
顎	()/chin
睦	intimate/friendly-relations
贄	()/sacrifice-offering
壷	()/jar
淵	()/deep-water
浦	bay/seaside
泌	ooze/secretions
涎	()/drool
慶	jubilation/joyous
唐	t'ang/china
俯	()/looked-down
隻	vessels/number-of-ships
斎	purification/private-libraries
巫	()/shrine-maidens
傲	()/arrogant
倣	emulate/mimic
冴	()/clear-headed
牧	breed/raises-livestock
遡	()/trace-back
胡	()/questionable
萌	()/began-to-sprout
暢	()/fluent
帥	commander
幌	canopy/car-covering
矮	()/dwarf-sized
嬌	attractive/charm
矯	rectify/correction
楼	watchtower/tall-buildings
辿	()/follow
迭	alternate/alternative
迂	()/detour
辻	crossing/crossroad
韻	rhyme
剖	divide/dissecting
拉	()/abducted
笠	bamboo hat/bamboo-hat
緻	()/closely
縺	()/tangled
縞	()/striped
糾	twist/complicated
醸	brew/brew-alcohol
酪	dairy products/dairy
晒	()/expose
洒	()/stylish-tone
牢	()/jail
竿	()/rods
芋	potato/potatoes
鋳	casting
鉤	()/hook
鋏	()/scissors
鎧	()/full-armor
箔	()/foil
箋	()/label
篠	()/bamboo-grass
籠	()/basket
煽	()/incited
灼	()/red-hot
炸	()/explosive
丹	cinnabar/earnest
鞍	()/saddles
帆	sail
彷	()/wander-aimlessly
紡	spinning
劫	()/extended-time-period
勃	()/sudden
崎	promontory/peninsula
埼	cape/long-peninsula
綺	()/lovely
阪	heights/gradient
岡	mount/small-hill
阜	()/large-hill
媛	beautiful-women
畿	()/capital-region
奈	nara
蛮	barbarian/barbaric
蛙	()/frogs
蝉	()/cicadas
螺	()/spiral
賓	v.i.p./visitor
窒	plug up/obstruction
寡	widow/small-amount-of
践	tread/implemented
蹄	()/hoof
踪	()/foot-prints
鮭	()/salmon
鮨	()/sushi
鮫	()/shark
餃	()/gyoza
曙	()/sunrise
孝	filial piety/respect-your-parents
巷	()/in-public
逐	pursue/sequential
塚	hillock/mound
遽	()/abrupt
曰	sayeth/it-is-said
昂	()/excitement
臼	()/rice-pounding-container
憾	remorse/feel-regret
惣	()/everything
惹	()/attracted
愁	distress
慈	mercy/compassion
憑	()/possessed
恣	()/as-you-please
棋	chess piece/shogi
槍	()/wooden-spears
栃	horse chestnut/horse-chestnuts
棲	()/inhabits
樽	()/barrel
槌	()/hammers
梱	()/pack-together
櫛	()/combs
楓	()/maple-trees
柵	()/wooden-fence
杭	()/stakes
桟	scaffold/pier
柳	willow-tree
柏	oak-tree
柿	()/persimmon
烏	crow
鴎	()/seagulls
潟	lagoon
鷲	()/eagle
鷹	()/hawk
鵜	()/swallow-whole
蔦	vine/ivy
奸	()/corrupt
婿	bridegroom/son-in-law
妃	queen/empress
汝	()/thou
姑	()/mother-in-law
姪	()/niece
姜	()/ginger
后	empress/queen
勿	not/must-not
斥	reject/repel
但	however
渾	()/all-of
軋	()/creaking
坦	()/smooth
藤	wisteria
脛	()/shins
腑	()/internal-organs
膳	()/low-dining-table
膿	()/pus
腱	()/tendon
嚇	upbraid/intimidate
囁	()/whispering
嘔	()/vomit
噌	()/miso
爺	()/grandfather
釜	()/cauldron
斧	()/axe
篤	fervent/wholehearted
馳	()/run-around
匙	()/spoon
仄	()/faint
凹	concave
凸	convex
訛	()/accent
諺	()/proverbs
訝	()/suspect
訣	()/secret-method
譜	musical score/sheet-music
謳	()/sing-together
諜	()/spy
那	()/mister
陛	highness/your-majesty
阿	africa/idiot
兎	()/rabbit
兜	()/helmet
禿	()/bald
栗	chestnut
朱	vermilion/vermillion-red
粟	()/millets
云	()/say-out-loud
仁	humanity/empathy
孔	cavity/small-hole
旺	()/prosperous
閏	()/leap-year
逞	()/athletic
只	only/just
苔	()/moss
侶	()/companion
頷	()/nodded
頒	partition/distribution
琴	harp/japanese-koto
咎	()/criticize
吟	versify/recites
嗽	()/gargling
